أنام = I sleep

أستيقظ = I wake up

أطبخ = I cook

أشتري = I buy

أركب = I ride (bus, car, bike)

أفتح التلفاز = I turn on the TV

أستخدم = I use

أرسل = I send

2️⃣ New Nouns

سرير = bed

سيارة = car

حاسوب = computer

هاتف = phone

مدرسة = school (you saw it once, let’s make it official now)

مكتب = desk / office

مطعم = restaurant

حقيبة = bag

3️⃣ New Adjectives

ثقيل = heavy

خفيف = light

جائع = hungry

عطشان = thirsty

متعب = tired

ذكي = smart

بارد = cold

حار = hot

4️⃣ New Prepositions

بجانب = beside / next to

قريب من = near to

بعيد عن = far from

داخل = inside

خارج = outside


أنت يرضاهي You satisfy me

عاشت ايدك Nice job!” / “Well done!” / “Respect for your work!

أين الحمام where is washroom


هذا (this)
إنها (it)

this is amazing
هذا مذهل







أنام sleep
