Verbs:

أفتح = I open

أغلق = I close

أدخل = I enter

أخرج = I go out

أساعد = I help

أزور = I visit

أحب = I love/like

أمشي = I walk

أركض = I run

Nouns:

الباب = door

النافذة = window

البيت = house

الغرفة = room

السوق = market

الحديقة = garden

صديق = friend

عائلة = family
table = الطاولة

Adjectives:

مفتوح = open

مغلق = closed

قريب = near

بعيد = far

جميل = beautiful

نظيف = clean

سريع = fast

بطيء = slow

Prepositions:

بجانب = next to

خلف = behind

أمام = in front of

بين = between

فوق = above

تحت = under

ألتقط (altaqiṭ) = I pick up (take something from the ground / grab).

أضع (aḍaʿ) = I put / place / drop (literally “I put down”).

“need” (أحتاج)
من هنا = “from here.”

أفتح
أقلخ
أدخل
أخلج


أساعد
أزور
أحب
أمشي
أركز
التقط
أضع

يتكلم (speak)

بالعربية = in Arabic

بالإنجليزية = in English

بالفرنسية = in French

بالألمانية = in German

بالإسبانية = in Spanish

بالباكستانية / بالأردية = in Urdu

ينظف clean
